1111111111111111111111111111111111
1E00000000C0000000000C000000000001
1010010100100000101001000000010101
10100100101C1010001001000000010101
1P00000000000010000100000000000001
1111111111111111111111111111111111