111111
1E0101
110CP1
111101
111111