1111111111111
10010000000C1
1000011111001
1P0011E001001
1000C0001C001
100CCCC001101
1111111111111