1111111111111
1E000000000C1
1010101C10101
1110000000001
1P100000000C1
1111111111111