1111111111111
1E000001000C1
1010101C10101
1111111111101
1P00000000011
1111111111111