1111111111111
1E0000E0000C1
1010101C10101
1010101C10101
1P0000P0000C1
1111111111111