111111
1C1001
100101
1P01E1
111111