111111
101C01
110101
1P01E1
111111